PapercutPath = PaperCut Server URL
PapercutAPIKey = PapercutAPI Key
PapercutPort = 9191

sqlBillingUser = SQL Server Username
sqlBillingPassword = SQL User Password
sqlBillingPath = QWL Server URL
sqlBillingDatabase = PapercutBilling
sqlBillingPrefix = dmofficeBilling_
sqlBillingType = MSSQL

oracleUser = Oracle User
oraclePassword = Oracle Password
oraclePath =  Oracle Path

ActiveDirectoryWhiteList = Active Directory Group A, Active Directory Group B  
ActiveDirectoryBlackList = Active Directory Group A, Active Directory Group B

BatchUserID = S$USER
BatchDetailCode = TEST

SFTPUser = username
SFTPPassword = 
SFTPKeyPath = 
SFTPServerPath = ftp.domain.url
SFTPPortNumber = 22
SFTPRemoteDirectory = 
WinSCPPath = 
SSHHostKeyFingerprint = 
FileProtocol =

SMTPServer = smtp.mail.url
SMTPPort = 25
SSLEnabled = false
SMTPUser = 
SMTPPassword = 
EmailFrom = PapercutBilling@mail.url
EmailTo = administrator1@mail.url, administrator2@mail.url
SendBillingSummary = true